╔═╦╗ ╔═══╗
║*╚╝ ║   ║
║    ║ ║ ║
╠═══ ║ ║ ║
║    ║ ║ ║
╠╗ ══╝ ║ ║
╠╣    *║ ║
╠╩═════╝ ║
║*       ║
╚═════ ══╝